111111111111111
11001C0000000C1
110000001000001
1C0000000001111
1P00011E0000011
111111111111111
